advantages - приемущества
patiently - терпеливо
immediate - мнгновенно
offer - предлагать
include - включает в себя
looking forward - с нетерпением ждать
diary - ежедневник
belong - принадлежать
parcel - посылка
suggestions - совет/рекомендации
tiny - крошечный
day off - выходной
argue - ругаться
especially - особенно
receipt - чек за товар
proceed to - перейдите к
fussy - придирчевый
fortune - целое состояние
survey - опрос
reasons - причина
frightened - страшный
look forward to - с нетерпением ждать
predictions - прогнозы
impatient - нетерпиливый
mealtimes - приём пищи
irritalbe - раздражительно
expect - ожидает
sequence - последовательность
cathedral - собор 
harbor - гавань/залив
temple - храм
town hall - мэрия
mosque - мечеть
liver - печень
incredibly - невероятно
go on - продолжать
spoiled - избалованный
get on with (somebody) - ладить/быть в хороших отношениях


AIRPORT:
arrivals - рейсы прибытия/зона прибытия
departures - рейсы вылета/зона вылета
bag drop - сдача багажа
baggage reclaim - выдача багажа
check-in - регистрация
customs - томожня
gates - ворота
terminal - здание с рейсами
trolley - тележка


FEELING ILL:
headache - головная боль
cough - кашель
flu - грипп